Test Adventure
//spawn point (room, y, x)
0 3 3
ROOMSTART
2 2 2 2 2 2 2 2 2 2 2 2 2 2
2 0 0 0 0 0 0 0 0 0 0 0 0 2
2 2 2 2 0 4 4 4 0 0 0 0 0 2
2 2 0 0 0 4 1 4 0 0 0 0 0 2
2 2 2 2 0 4 1 4 0 0 0 0 0 2
0 0 0 4 0 4 1 4 0 0 0 0 0 2
0 0 0 4 0 4 4 4 0 0 0 0 0 2
2 0 0 4 0 0 0 0 0 0 0 0 0 2
2 2 2 2 2 2 0 0 0 0 0 0 0 2
2 2 2 2 2 2 0 0 0 2 2 2 2 2
BGM song02
WALL 2 1
WALL 3 2
ROOMEND
ROOMSTART
2 2 2 2 2 2 0 0 0 2 2 2 2 2
2 2 2 3 2 0 0 0 0 0 0 0 0 2
2 0 0 0 0 0 0 0 0 1 0 1 0 2
2 0 0 0 0 0 0 0 0 0 4 0 0 2
2 0 0 0 0 1 1 1 0 1 0 1 0 2
2 0 0 0 0 1 0 1 0 0 0 0 0 2
2 0 0 0 0 1 1 1 0 0 0 0 0 2
2 0 0 0 0 0 0 0 0 0 0 0 0 2
2 0 0 0 0 0 0 0 0 0 0 0 0 2
2 2 2 2 2 2 2 2 2 2 2 2 2 2
BGM song02
TELE 1 3 3 9 5
TELE 3 10 2 4 1
WALL 0 0
ROOMEND
ROOMSTART
2 2 2 2 2 2 2 2 2 2 2 2 2 2
2 0 0 0 0 0 0 0 0 0 0 0 0 2
2 1 0 0 0 0 0 0 0 0 2 2 0 2
2 1 1 0 0 0 0 0 0 0 2 0 0 2
2 0 0 0 0 0 0 0 0 0 2 0 0 2
2 1 1 0 0 0 0 0 0 0 2 0 0 0
2 1 0 0 0 0 0 0 0 0 2 0 0 0
2 0 0 0 0 0 0 0 0 0 2 0 0 2
2 0 0 0 0 0 0 0 0 0 2 0 0 2
2 2 2 2 2 2 2 2 2 2 2 2 2 2
BGM song02
WALL 1 0
ROOMEND
ROOMSTART
2 2 2 2 2 2 2 2 2 2 2 2 2 2
2 2 2 2 2 2 2 2 2 2 2 2 2 2
2 2 0 0 0 0 0 0 0 0 0 0 2 2
2 2 0 0 0 0 0 0 0 0 0 0 2 2
2 2 0 0 0 0 0 0 0 0 0 0 2 2
2 2 0 0 0 0 0 0 0 0 0 0 2 2
2 2 2 2 2 0 0 0 0 0 0 0 2 2
2 2 2 2 2 0 0 0 0 0 0 0 2 2
2 2 2 2 2 0 2 2 2 2 2 2 2 2
2 2 2 2 2 0 2 2 2 2 2 2 2 2
BGM song04
TELE 10 5 1 2 3
ROOMEND